....@=..............
.....=..............
.....=............@.
.....=..............
.....=..............
.....=%%............
...@.=%%............
.....=..............
.....=....%%......@.
..@..=....%%........
~~~~~=~~~~~~~~~~~~~~
.....=............@.
.....=.........%%...
.....=.........%%...
.....=..............
.....=..............
.....=...........@..
...%%=%.............
...%%=%.............
.....=..............
